    #       #
# # # ##### #
### #     # #
#    #### # #
#### ## # # #
#  # ## # # #
## # ## # # #
#         # #
####### ### #
#       #    
