# # # # # # # # # # # # #
        #               #
#   #   #   # # # # #   #
# # #   #           #   #
#         # # # #   #   #
# # # #   # #   #   #   #
#     #   # #   #   #   #
# #   #   # #   #   #   #
#                   #   #
# # # # # # #   # # #   #
#               #        
# # # # # # # # # # # # #
